00000000000000000000
01111101111111111110
01111101111111111110
00000001111111111110
01110101111111111110
00000100000000001110
01110111111111101110
00000111111111100000
11110111111111101110
00000000000000000000
01110111111111101110
01110000000000001110
00000111111111100000
